AAAAAAAAAA
BQRRRRRRRA
BRQRRRRRRA
BRRRRRRRRA
BRRRRRRRRA
BRRRRRRRRA
AAAAAAAAAA
          
          
          