AAAAAAAA   AAAAAA   AAAAAAAA
ARRRRRRA   ARRRRA   ARRRRRRA
ARRRRRRA   ARRRRA   ARRRRRRA
ARRRRRRA   ARRRRA   ARRRRRRA
ARRRRRRA   ARRRRA   ARRRRRRA
ARRRRRRA   ARRRRA   ARRRRRRA
ARRRRRRA   ARRRRA   ARRRRRRA
AAAAAAAA   ARRRRA   AAAAAAAA
           ARRRRA           
           ARRRRA           
AAAAAAAAAAAARRRRAAAAAAAAAAAA
ARRRRRRRRRRRRRRRRRRRRRRRRRRA
ARRRRRRRRRRRRRRRRRRRRRRRRRRA
ARRRRRRRRRRRRRRRRRRRRRRRRRRA
ARRRRRRRRRRRRRRRRRRRRRRRRRRA
AAAAAAAAAAAARRRRAAAAAAAAAAAA
           ARRRRA           
           ARRRRA           
AAAAAAAA   ARRRRA   AAAAAAAA
ARRRRRRA   ARRRRA   ARRRRRRA
ARRRRRRA   ARRRRA   ARRRRRRA
ARRRRRRA   ARRRRA   ARRRRRRA
ARRRRRRA   ARRRRA   ARRRRRRA
ARRRRRRA   ARRRRA   ARRRRRRA
ARRRRRRA   ARRRRA   ARRRRRRA
AAAAAAAA   AAAAAA   AAAAAAAA