WWWWWWWWWWWWWWWWWWWWWWWWWWWW
W             WWWWWWWWWWWWWW
W W W W W W W WWWWWWWWWWWWWW
W R       B B WWWWWWWWWWWWWW
WBW W W W WBW WWWWWWWWWWWWWW
W  P    R  B  WWWWWWWWWWWWWW
W W W W W W W WWWWWWWWWWWWWW
WB   B   B    WWWWWWWWWWWWWW
WBW W W WBW W WWWWWWWWWWWWWW
W    YBB   B BWWWWWWWWWWWWWW
W WBW W W W W WWWWWWWWWWWWWW
W        B   GWWWWWWWWWWWWWW
WWWWWWWWWWWWWWWWWWWWWWWWWWWW
WWWWWWWWWWWWWWWWWWWWWWWWWWWW
W             WWWWWWWWWWWWWW
W W W W W W W WWWWWWWWWWWWWW
W R       B B WWWWWWWWWWWWWW
WBW W W W WBW WWWWWWWWWWWWWW
W  P    R  B  WWWWWWWWWWWWWW
W W W W W W W WWWWWWWWWWWWWW
WB   B   B    WWWWWWWWWWWWWW
WBW W W WBW W WWWWWWWWWWWWWW
W    YBB   B BWWWWWWWWWWWWWW
W WBW W W W W WWWWWWWWWWWWWW
W        B   GWWWWWWWWWWWWWW
WWWWWWWWWWWWWWWWWWWWWWWWWWWW
W        B   GWWWWWWWWWWWWWW
WWWWWWWWWWWWWWWWWWWWWWWWWWWW
