AAAAAAAAAAAAAAAAAAAAAAAAAAAA
BQQQQQQQQQQQQQQQQQQQQQQQQQQA
AQQQQQQQQQQQQQQQQQQQQQQQQQQA
AQQQQQQQQQQQQQQQQQQQQQQQQQQA
AQQQQQQQQQQQQQQQQQQQQQQQQQQA
AQQQQQQQQQQQQQQQQQQQQQQQQQQA
AQQQQQQQQQQQQQQQQQQQQQQQQQQA
AQQQQQQQQQQQQQQQQQQQQQQQQQQA
AQQQQQQQQQQQQQQQQQQQQQQQQQQA
AQQQQQQQQQQQQQQQQQQQQQQQQQQA
AQQQQQQQQQQQQQQQQQQQQQQQQQQA
AQQQQQQQQQQQQQQQQQQQQQQQQQQA
AQQQQQQQQQQQQQQQQQQQQQQQQQQA
AQQQQQQQQQQQQQQQQQQQQQQQQQQA
AQQQQQQQQQQQQQQQQQQQQQQQQQQA
AQQQQQQQQQQQQQQQQQQQQQQQQQQA
AQQQQQQQQQQQQQQQQQQQQQQQQQQA
AQQQQQQQQQQQQQQQQQQQQQQQQQQA
AQQQQQQQQQQQQQQQQQQQQQQQQQQA
AQQQQQQQQQQQQQQQQQQQQQQQQQQA
AQQQQQQQQQQQQQQQQQQQQQQQQQQA
AQQQQQQQQQQQQQQQQQQQQQQQQQQA
AQQQQQQQQQQQQQQQQQQQQQQQQQQA
AQQQQQQQQQQQQQQQQQQQQQQQQQQA
AQQQQQQQQQQQQQQQQQQQQQQQQQQA
AQQQQQQQQQQQQQQQQQQQQQQQQQQA
AQQQQQQQQQQQQQQQQQQQQQQQQQQA
AAAAAAAAAAAAAAAAAAAAAAAAAAAA
