AAAAAAAAAAAAAAAAAAAAAAAAAAAA
BQQQQQQQQQQQQQQQQQQQQQQQQQQA
AQQQQQQQQQSQQQQQQQQQQQQQQQQA
AQQQQQQQQQQQQQQQQQQQQQQQQQQA
AQQQQQQQQQTQQQQQQQQQQQQQQQQA
AQQQQQQQQQQQQQQQQQQQQQQQQQQA
AQQQQQQQQQQQQQQSQQQQQQQQQQQA
AQQQQQQQQQQQQQQQQQQQQQQQQQQA
AQQQQQQQQQQQQQQQQQQQQQQQQQQA
AQQQQQQQQQQQQQQQQQQQQQQQQQQA
AQQQQQQQQQQQQQQQQQQQQQQQQQQA
AQQQQQQQQQQQQQQQQQQQQQQQQQQA
AQQQQQQQQQQQQQQQQQQQQQQQQQQA
AQQQQQQQQQQQQQQQQQQQQQQQQQQA
AQQQQQQQQQQQQQQQQQQQQQQQQQQA
AQQQQQQQQQQQQQQQQQQQQQQQQQQA
AQQQQQQQQQQQQQQQQQQQQQQQQQQA
AQQQQQQQQQQQQQQQQQQQQQQQQQQA
AQQQQQQQQQQQQQQQQQQQQQQQQQQA
AQQQQQQQQQQQQQQQQQQQQQQQQQQA
AQQQQQQQQQQQQQQQQQQQQQQQQQQA
AQQQQQQQQQQQQQQQQQQQQQQQQQQA
AQQQQQQQQQQQQQQQQQQQQQQQQQQA
AQQQQQQQQQQQQQQQQQQQQQQQQQQA
AQQQQQQQQQQQQQQQQQQQQQQQQQQA
AQQQQQQQQQQQQQQQQQQQQQQQQQQA
AQQQQQQQQQQQQQQQQQQQQQQQQQQA
AAAAAAAAAAAAAAAAAAAAAAAAAAAA
