AAAAAAAAAAAAAAAAAAAAAAAAAAAA
AQQQQQQQQQQQQQQQQQQQQQQQQQQA
AQQQQQQQQQQQQQQQQQQQQQQQQQQA
AQQQQQQQQQQQQQQQQQQQQQQQQQQA
BQQQQQQQQQQQQQQQQQQQQQQQQQQE
AQQQQQQQQQQQQQQQQQQQQQQQQQQA
AQQQQQQQQQQQQQQQQQQQQQQQQQQA
AQQQQQQQQQQQQQQQQQQQQQQQQQQA
AQQQQQQQQQQQQQQQQQQQQQQQQQQA
AQQQQQQQQQQQQQQQQQQQQQQQQQQA
AQQQQQQQQQQQQQQQQQQQQQQQQQQA
AQQQQQQQQQQQQQQQQQQQQQQQQQQA
AQBQQQQQQQEQBQQQQQQQQQQEQQQA
AQQQQQQQQQQQQQQQQQQQQQQQQQQA
AQQQQQQQQQQQQQQQQQQQQQQQQQQA
AQQQQQQQQQQQQQQQQQQQQQQQQQQA
AQQQQQQQQQQQQQQQQQQQQQQQQQQA
AQQQQQQQQQQQQQQQQQQQQQQQQQQA
AQQQQQQQQQQQQQQQQQQQQQQQQQQA
AQQQQQQQQQQQQQQQQQQQQQQQQQQA
AQQQQQQQQQQQQQQQQQQQQQQQQQQA
AQQQQQQQQQQQQQQQQQQQQQQQQQQA
AQQQQQQQQQQQQQQQQQQQQQQQQQQA
BQQQQQQQQQQQQQQQQQQQQQQQQQQE
AQQQQQQQQQQQQQQQQQQQQQQQQQQA
AQQQQQQQQQQQQQQQQQQQQQQQQQQA
AQQQQQQQQQQQQQQQQQQQQQQQQQQA
AAAAAAAAAAAAAAAAAAAAAAAAAAAA
