AAAAAAAAAAAAAAAAAAAAAAAAAAAA
CQQQQQQQQQQQQQQQQQQQQQQQQQQA
AQQQQQQQQQQQQQQQQQQQQQQQQQQA
AQQQQQQQQQQQQQQQQQQQQQQQQQQA
AQQQQQQQQQQQQQQQQQQQQQQQQQQA
AQQQQQQQQQQQQQQQQQQQQQQQQQQA
AQQQQQQQQQQQQQQQQQQQQQQQQQQA
AQQQQQQQQQQQQQQQQQQQQQQQQQQA
AQQQQQQQQQQQQQQQQQQQQQQQQQQA
AQQQQQQQQQQQQQQQQQQQQQQQQQQA
AQQQQQQQQQQQQQQQQQQQQQQQQQQA
AQQQQQQQQQQQQQQQQQQQQQQQQQQA
AQQQQQQQQQQQQQQQQQQQQQQQQQQA
AQQQQQQQQQQQQQQQQQQQQQQQQQQA
AQQQQQQQQQQQQQQQQQQQQQQQQQQA
AQQQQQQQQQQQQQQQQQQQQQQQQQQA
AQQQQQQQQQQQQQQQQQQQQQQQQQQA
AQQQQQQQQQQQQQQQQQQQQQQQQQQA
AQQQQQQQQQQQQQQQQQQQQQQQQQQA
AQQQQQQQQQQQQQQQQQQQQQQQQQQA
AQQQQQQQQQQQQQQQQQQQQQQQQQQA
AQQQQQQQQQQQQQQQQQQQQQQQQQQA
AQQQQQQQQQQQQQQQQQQQQQQQQQQA
AQQQQQQQQQQQQQQQQQQQQQQQQQQA
AQQQQQQQQQQQQQQQQQQQQQQQQQQA
AQQQQQQQQQQQQQQQQQQQQQQQQQQA
AQQQQQQQQQQQQQQQQQQQQQQQQQQA
AAAAAAAAAAAAAAAAAAAAAAAAAAAA
