AIIIIIIA    AIIIIIIA
AQQQQSQA    AQQQQQQA
AQQQQQQA    AQQQQQQA
AQQQQQQA    AQTUQQQA
AQQQQQQA    AQQQQQQA
AQQQQQQA    AQQQQQQA
AQQQQQQA    AQQQQQQA
AAAAAAAA    AAAAAAAA
                    
                    
                    
                    
AAAAAAAA    AAAAAAAA
AQQQQQQA    AQQQQQQA
AQQQQQQA    AQQQQQQA
AQQQQQQA    AQQQQQQA
AQQUQQQA    AQQSQQQA
AQQQQQQA    AQQQQQQA
AQQQQQQA    AQQQQQQA
ACCCCCCA    ACCCCCCA