AAAAAAAA    AAAAAAAA
ARRRRRRA    ARRRRRRA
ARRRRRRA    ARRRRRRA
ARRRRRRA    ARRRRRRA
ARRRRRRA    ARRRRRRA
ARRRRRRA    ARRRRRRA
ARRRRRRA    ARRRRRRA
ACCCCCCA    ACCCCCCA
                    
                    
                    
                    
AIIIIIIA    AIIIIIIA
ARRRRRRA    ARRRRRRA
ARRRRRRA    ARRRRRRA
ARRRRRRA    ARRRRRRA
ARRRRRRA    ARRRRRRA
ARRRRRRA    ARRRRRRA
ARRRRRRA    ARRRRRRA
AAAAAAAA    AAAAAAAA