                        
     AAAAAAAAAAAAAAAA   
     AQQQQQQQQQQQQQQA   
  A  AQQQQQQQQQQQQQQA   
     AQQQQQQQQQQTQQQA   
  R  AQQQQIQQQQQQQQQA   
     AQQQQQQQQQQQQSQAAA 
  C  AQQQQQQQQQQQQQQQQA 
     AQQQQQQQQQQTQQQQQA 
     AAAAQQQQQQQQQQQQQA 
        ABQQQQQEQQQQQQA 
        AQQQQQQQQQQQQQA 
        AACAAACAAAAAAAA 
                        
              AAAA      
     AAAAAA   A  A      
     A    AAAAA  A      
   AAA           A AAAAA
   A        AAAAAA A   A
   A        A      A AAA
   AAAA  AA A      A AAA
      A AAA AAAAAAAA   A
      A A A          AAA
      AAA AAAAAAAAAAAA  