                        
 R A AAAAAAAAAAAAAAAA   
     AQQQQQQQQQQQQQQA   
  A  AQQQQQQQQQQQQQQA   
     AQQQQQQQQQQTQQQA   
  T  AQQQQIQQQQQQQQQA   
     AQQQQQQQQQQQQSQAAA 
  C  AQQQQQQQQQQQQQQQQA 
     AQQQQQQQQQQTQQQQQA 
 CC  AAAAQQQQQQQQQQQQQA 
 CC     ABQQQQQEQQQQQQA 
 CC QQQQAQQQQQQQQQQQQQA 
 CC QQQQAACAAACAAAAAAAA 
 CC QQQQ                
  C           AAAA      
     AAAAAA   ASSA      
     ASSSSAAAAASSA      
   AAASSSSSSSSSSSA AAAAA
   ASSSSSSSSAAAAAA ASSSA
   ASSSSSSSSA      ASAAA
   AAAASSAASA      ASAAA
      ASAAASAAAAAAAASSSA
      ASA ASSSSSSSSSSAAA
      AAA AAAAAAAAAAAA  