                        
     AAAAAAAAAAAAAAAA   
     ARRRRRRRRRRRRRRA   
  A  ARRRRRRRRRRRRRRA   
     ARRRRRRRRRRRRRRA   
  R  ARRRRARRRRRRRRRA   
     ARRRRRRRRRRRRRRAAA 
  B  ARRRRRRRRRRRRRRRRA 
     ARRRRRRRRRRRRRRRRA 
     AAAARRRRRRRRRRRRRA 
        AARRRRRARRRRRRA 
        ARRRRRRRRRRRRRA 
        AAAAAAAAAAAAAAA 
                        
              AAAA      
     AAAAAA   A  A      
     A    AAAAA  A      
   AAA           A AAAAA
   A        AAAAAA A   A
   A        A      A AAA
   AAAA  AA A      A AAA
      A AAA AAAAAAAA   A
      A A A          AAA
      AAA AAAAAAAAAAAA  