                        
 R A AAAAAAAAAAAAAAAA   
     ARRRRRRRRRRRRRRA   
  A  ARRRRRRRRRRRRRRA   
     ARRRRRRRRRRRRRRA   
  R  ARRRRARRRRRRRRRA   
     ARRRRRRRRRRRRRRAAA 
  B  ARRRRRRRRRRRRRRRRA 
     ARRRRRRRRRRRRRRRRA 
 BB  AAAARRRRRRRRRRRRRA 
 BB     AARRRRRARRRRRRA 
 BB RRRRARRRRRRRRRRRRRA 
 BB RRRRAAAAAAAAAAAAAAA 
 BB RRRR                
  B           AAAA      
     AAAAAA   ARRA      
     ARRRRAAAAARRA      
   AAARRRRRRRRRRRA AAAAA
   ARRRRRRRRAAAAAA ARRRA
   ARRRRRRRRA      ARAAA
   AAAARRAARA      ARAAA
      ARAAARAAAAAAAARRRA
      ARA ARRRRRRRRRRAAA
      AAA AAAAAAAAAAAA  