AAAAAAAAAAA      AAAAAAAAAAA
AQQQQQQQQQA      AQQQQQQQQQA
AQQQQQQQQQA      AQQQQQQQQQA
AQQQQQQQQQA      AQQQQQQQQQA
AQQQQQQQQQA      AQQQQQQQQQA
AQQQQQQQQQA      AQQQQQQQQQA
AQQQQQQQQQA      AQQQQQQQQQA
AQQQQQQQQQAAAAAAAAQQQQQQQQQA
AQQQQQQQQQSQSQSQSQQQQQQQQQQA
AQQQQQQQQQQSQSQSQSQQQQQQQQQA
AQQQQQQQQQAAAAAAAAQQQQQQQQQA
AQQQQQQQQQA      AQQQQQQQQQA
AQQQQQQQQQA      AQQQQQQQQQA
AQQQQQQQQQA      AQQQQQQQQQA
AQQQQQQQQQA      AQQQQQQQQQA
AQQQQQQQQQA      AQQQQQQQQQA
AQQQQQQQQQA      AQQQQQQQQQA
AAAAAAAAAAA      AAAAAAAAAAA