AAAAAAAAAAA      AAAAAAAAAAA
ARRRRRRRRRA      ARRRRRRRRRA
ARRRRRRRRRA      ARRRRRRRRRA
ARRRRRRRRRA      ARRRRRRRRRA
ARRRRRRRRRA      ARRRRRRRRRA
ARRRRRRRRRA      ARRRRRRRRRA
ARRRRRRRRRA      ARRRRRRRRRA
ARRRRRRRRRAAAAAAAARRRRRRRRRA
ARRRRRRRRRRRRRRRRRRRRRRRRRRA
ARRRRRRRRRRRRRRRRRRRRRRRRRRA
ARRRRRRRRRAAAAAAAARRRRRRRRRA
ARRRRRRRRRA      ARRRRRRRRRA
ARRRRRRRRRA      ARRRRRRRRRA
ARRRRRRRRRA      ARRRRRRRRRA
ARRRRRRRRRA      ARRRRRRRRRA
ARRRRRRRRRA      ARRRRRRRRRA
ARRRRRRRRRA      ARRRRRRRRRA
AAAAAAAAAAA      AAAAAAAAAAA