AIIIIIIIIIIIIIIIIIIA
BQQQQQQQQQQQQQQQQQQE
BQQQQQQQQQQQQQQQQQQE
BQQQQQQQQQQQQQQQQQQE
BQQQQQQQQQQQQQQQQQQE
BQQQQQQQQQQQQQQQQQQE
BQQQQQQQQQQQQQQQQQQE
BQQQQQQQQQQQQQQQQQQE
BQQQQQQQQQQQQQQQQQQE
BQQQQQQQQQQQQQQQQQQE
BQQQQQQQQQQQQQQQQQQE
BQQQQQQQQQQQQQQQQQQE
BQQQQQQQQQQQQQQQQQQE
ACCCCCCCCCCCCCCCCCCA