                              
                     III      
                   IJQQQMI    
                 IJQQQQQQQM   
               IJQQQQQQQQQQM  
             IJQQQQQQQQQQQQQE 
           IJQQQQQQQQQQQQQQQM 
         IJQQQQQQQQQQQQQQQQQQE
       IJQQQQQQQQQQQQQQQQQQQQE
     IJQQQQQQQQQQQQQQQQQQQQQEA
   ABRRQQQQQQQQQQQQQQQQQQQQFRE
 AARRCCCCDQQQQQQQQQQQQQQQEBQQE
ARRAARRBRREAAABQQQQQQEAABQQQQE
AARRARARDRQQQQQEAAAABQQQQQQGC 
AARRRARARDQQQQQQQQQQQQQQQGC   
ARAARRARRBQQQQQQQQQQQQQGC     
ARRRARRAARDQQQQQQQQQQGC       
ARRRRARRARBQQQQQQQQGC         
 ARRRARRRABQQQQQQGC           
 ARRRRAARRBQQQQGC             
  ARRRRARRBQQGC               
   ARRRRARACC                 
    AARRRAA                   
      AAAA                    