AAAAAAA       
BRRRRRE AAAAAA
ARIRRRAAJURRRE
ARRRRRARRRRRRA
AARRRRABRRIREA
 ARRURARRRRRA 
 ARRAAARRRRRA 
 ACAA BRRRRRE 
      AACACAA 
