AAAAAAAAAA
AQQQQQQQQA
AQUQQQQQQA
AQQQQQQQQA
AQQQQQQQQA
AQQQQQQQQA
AQQQQQQQQA
AQQQQQQUQA
AQQQQQQQQA
AAAAAAAAAA