                 AAAAAAAAA      
  AAAAAAAAAAA  AASSSSSSRSRA     
  ARSRSSSSSAAAAAAAAAASRSSRA     
  ARSSRSSAAAAAAQQQQQAAASRA      
   ARSRSAAAQQQQQQQQQQQAARA      
   ARSSAAAQQQQQQQQQQQQQAA       
    ARAAAQQQQQQQQQQQQQQQAA      
    AAAAQQQQQQQQQQQQQQQQQAA     
    AAAAQQQQQQQQQQQQQQQQTQA     
   ARAAAQQQQQQQQQQQQATTTQQAA    
   AQQAQQQATTTTQTTTQAQQQQQQA    
   AQQAQQAQQQQQAQQQAAQQQAQQA    
   AQQAQAQQQQQAAQQAAARARAARA    
   AQQQQAQQQQAAARAARAAARAAAA    
    AQQQQQAAAAAAAAQQARAAAAA     
    AQQQQQQARAARAQQQSQQAA A     
    AQQAQQQQQQSQQQQQTQQA        
    AQQAAAQQQSTQQQQQSQQA        
    ARAAAAQQQSSQQQQQQQQA        
   AARAAAAQQQQQQQQQQQARA        
   AAAAARAAQAQQQQQQQARA         
   AAAA ARAQQQQQQQQQQA          
    AAA ARAQQQQQQQQQARA         
    AA   AQQQQQQQQQQARA         
    A    AQQQAQQQQQQQARA        
        AQSQQAQQQQQQQQAA        
        AQQSQAQQQQQQQQQA        
        AQQQQQQQQQQQQQTA        
        AQQQQQQQQQQQTTA         
         AQTTTQQTTAARA          
          AAARAAAA AA           
            AA                  