                 AAAAAAAAA      
  AAAAAAAAAAA  AARRRRRRRRRA     
  ARRRRRRRRAAAAAAAAAARRRRRA     
  ARRRRRRAAAAAARRRRRAAARRA      
   ARRRRAAARRRRRRRRRRRAARA      
   ARRRAAARRRRRRRRRRRRRAA       
    ARAAARRRRRRRRRRRRRRRAA      
    AAAARRRRRRRRRRRRRRRRRAA     
    AAAARRRRRRRRRRRRRRRRRRA     
   ARAAARRRRRRRRRRRRARRRRRAA    
   ARRARRRARRRRRRRRRARRRRRRA    
   ARRARRARRRRRARRRAARRRARRA    
   ARRARARRRRRAARRAAARARAARA    
   ARRRRARRRRAAARAARAAARAAAA    
    ARRRRRAAAAAAAARRARAAAAA     
    ARRRRRRARAARARRRRRRAA A     
    ARRARRRRRRRRRRRRRRRA        
    ARRAAARRRRRRRRRRRRRA        
    ARAAAARRRRRRRRRRRRRA        
   AARAAAARRRRRRRRRRRARA        
   AAAAARAARARRRRRRRARA         
   AAAA ARARRRRRRRRRRA          
    AAA ARARRRRRRRRRARA         
    AA   ARRRRRRRRRRARA         
    A    ARRRARRRRRRRARA        
        ARRRRARRRRRRRRAA        
        ARRRRARRRRRRRRRA        
        ARRRRRRRRRRRRRRA        
        ARRRRRRRRRRRRRA         
         ARRRRRRRRAARA          
          AAARAAAA AA           
            AA                  