AAAAAAA       
BTTTRSE AAAAAA
ARITSSAAJURRRE
ARTTSRARRRRRRA
AARRSRABRRIREA
 ATTURARRRRRA 
 ATRRAARRRRRA 
 ACARABRRRRRE 
   ARAAACRCAA 
   ARA  ARA   
   ARA  ARA   
   ARA  ARA   
   ARA  ARA   
   ARA  ARA   
AAAARA  ARAAAA
ARRRRA  AQQQQA
ARRRRA  AQQQQA
ARRRRA  AQQQQA
ARRRRA  AQQQQA
ARRRRA  AQQQQA
ARRRRA  AQQQQA
AAAAAA  AAAAAA