AAAAAAA       
ARRRRRA AAAAAA
ARARRRAAARRRRA
ARRRRRARRRRRRA
AARRRRAARRARAA
 ARRRRARRRRRA 
 ARRRAARRRRRA 
 AABREARRRRRA 
   BREAABREAA 
   BRE  BRE   
   BRE  BRE   
   BRE  BRE   
   BRE  BRE   
   BRE  BRE   
AIIJRE  BRMIIA
BRRRRE  BRRRRE
BRRRRE  BRRRRE
BRRRRE  BRRRRE
BRRRRE  BRRRRE
BRRRRE  BRRRRE
BRRRRE  BRRRRE
ACCCCA  ACCCCA