 AIIIIIIIIIIIIA 
AJQQQQQQQQQQQQMA
BQQQQQQQQQQQQQQE
BQQQQQQQQQQQQQQE
BQQQQAAAAAAQQQQE
BQQQQAAAAAAQQQQE
BQQQQQQQQQQQQQQE
BQQQQQQQQQQQQQQE
ADQQQQQQQQQQQQGA
 ACCCCCCCCCCCCA 