 AAAAAAAAAAAAAA 
AARRRRRRRRRRRRAA
ARRRRRRRRRRRRRRA
ARRRRRRRRRRRRRRA
ARRRRGCCCCDRRRRA
ARRRRMIIIIJRRRRA
ARRRRRRRRRRRRRRA
ARRRRRRRRRRRRRRA
AARRRRRRRRRRRRAA
 AAAAAAAAAAAAAA 