AIAIAIAIAIAA
BRRRRRRRRRRE
ARRRRRRRRRRA
BRRRRRRRRRRE
ARRRRRRRRRRA
BRRRRRRRRRRE
ARRRRRRRRRRA
BRRRRRRRRRRE
ARRRRRRRRRRA
BRRRRRRRRRRE
ARRRRRRRRRRA
ACACACACACAA