6,7,6,7
-1,0,5,7
-1,0,4,7
-1,0,3,7
-1,0,2,7
0,-1,2,6
0,-1,2,5
