     AAAAAA     
   AAQQQQQQAA   
  AQQQQQQQQQQA  
 AQQQQQQQQQQQQA 
 AQQQQQQQQQQQQA 
AQQQQQQQQQQQQQQA
AQQQQQQQQQQQQQQA
AQQQQQQQQQQQQQQA
AQQQQQQQQQQQQQQA
AQQQQQQQQQQQQQQA
AQQQQQQQQQQQQQQA
 AQQQQQQQQQQQQA 
 AQQQQQQQQQQQQA 
  AQQQQQQQQQQA  
   AAQQQQQQAA   
     AAAAAA     