     AAAAAA     
   AARRRRRRAA   
  ARRRRRRRRRRA  
 ARRRRRRRRRRRRA 
 ARRRRRRRRRRRRA 
ARRRRRRRRRRRRRRA
ARRRRRRRRRRRRRRA
ARRRRRRRRRRRRRRA
ARRRRRRRRRRRRRRA
ARRRRRRRRRRRRRRA
ARRRRRRRRRRRRRRA
 ARRRRRRRRRRRRA 
 ARRRRRRRRRRRRA 
  ARRRRRRRRRRA  
   AARRRRRRAA   
     AAAAAA     