         AIA        
 AIIIIIIIBRMIIIIIIIA
 BRRRRRRRFRRRRRRRRRE
 BROKKKKKAKKKKKCKLRE
 BRRRRRRRFRRRRRFRRRE
 BRGKDRHRFRHRHRFRGKA
 BRFRFRFRFRFRFRFRFRE
 AKJRMKJRFRFRFRNRFRE
 BRRRRRRRFRFRFRRRFRE
 BRGKKKKKJRMKBROKJRE
 BRFRRRRRRRRRFRRRRRE
 BRFRHRHRHRGKBRGKCKA
 BRFRFRFRFRFRFRFRFRE
 BRFRFREKIKJRMKJRFRE
 BRFRFRFRRRRRRRRRFRE
 BRFRMKJRODRGKKLRFRE
 BRFRRRRRRFRFRRRRFRE
 BRMKKKLRGIKILRHRNRE
 BRRRRRRRFRRRRRFRRRE
 ACCCCCCCBRGCCCACCCA
 AARRRRRRRRRRRRRRAAA
  ARRRRRRRRRRRRRRA  
  ARRRRRRRRRRRRRRA  
  AAAAAAAAAAAAAAAA  