                   AIA        
AAAAAAAAAAAAAAIAIIIJRMIAIIIIIA
ARRRRRRRRRRRRBRFRRRRRRRFRRRRRE
ARRRRRRRRRRRRBRFRGCDRHRNRHRHRE
ARRRRRRRRRRRRBRFRFRFRFRRRFRFRE
ARRRRRRRRRRRRBRFRFRFRFRGKJRFRE
ARRRRRRRRRRRRBRFRFRFRFRFRRRFRE
ARRRRRRRRRRRRBRNRFRNRFRFROKJRE
ARRRRRRRRRRRRBRRRFRRRFRFRRRRRE
ARRRRRRRRRRRRBROKJRGKJREKKKLRE
ARRRRRRRRRRRRBRRRRRFRRRFRRRRRE
ARRRRRRRRRRRRAKLRHRNRHRNRHROKA
ARRRRRRRRRRRRBRRRFRRRFRRRFRRRE
ARRRRRRRRRRRRBRGKIKCKJRGKIKLRE
AAAAAAAAAAAAABRFRRRFRRRFRRRRRE
             BRNRHRMKKKJRGKLRE
             BRRRFRRRRRRRFRRRE
             ACCCACCCDRGCACCCA
                     BRE      
                     BRE      
                     ACA      