AAAAAAAAAAAAAAAAAAAAAAAA
AQQQQQQQQQQQQQQQQQQQQQQA
AQQQQQQQQQQQQQQQQQQQQQQA
AQQUQQQQQQQQQQQQQQQQUQQA
AQQQQQQQQQQQQQQQQQQQQQQA
AQQQQQQQQQQQQQQQQQQQQQQA
AQQQQQAAAAAAAAAAAAQQQQQA
AQQQQQA          AQQQQQA
AQQQQQA          AQQQQQA
AQQQQQA          AQQQQQA
AQQSQQA          AQQQQQA
AQQQQQA          AQQQQQA
AQQQQQA          AQQQQQA
AQQQQQA          AQQQQQA
AQQQQQA          AQQQQQA
AQQQQQA          AQQQQQA
AQQQQQA          AQQQQQA
AQQQQQAAAAAAAAAAAAQQQQQA
AQQQQQQQQQSQQQQQQQQQQQQA
AQQQQQQQQQQQQQQQQQQQQQQA
AQQQQQQQQQQQQQQQQQQQQQQA
AQQQQQQQQQQQQQQQQQQQQQQA
AQQQQQQQQQQQQQQQQQQQQQQA
AAAAAAAAAAAAAAAAAAAAAAAA