AIIIIIIIIIIIIIIIIIIIIIIA
BRRRRRRRRRRRRRRRRRRRRRRE
BRRRRRRRRRRRRRRRRRRRRRRE
BRRRRRRRRRRRRRRRRRRRRRRE
BRRRRRRRRRRRRRRRRRRRRRRE
BRRRRRRRRRRRRRRRRRRRRRRE
BRRRRRGCCCCCCCCCCDRRRRRE
BRRRRRE          BRRRRRE
BRRRRRE          BRRRRRE
BRRRRRE          BRRRRRE
BRRRRRE          BRRRRRE
BRRRRRE          BRRRRRE
BRRRRRE          BRRRRRE
BRRRRRE          BRRRRRE
BRRRRRE          BRRRRRE
BRRRRRE          BRRRRRE
BRRRRRE          BRRRRRE
BRRRRRMIIIIIIIIIIJRRRRRE
BRRRRRRRRRRRRRRRRRRRRRRE
BRRRRRRRRRRRRRRRRRRRRRRE
BRRRRRRRRRRRRRRRRRRRRRRE
BRRRRRRRRRRRRRRRRRRRRRRE
BRRRRRRRRRRRRRRRRRRRRRRE
ACCCCCCCCCCCCCCCCCCCCCCA