AAAAAAAAAAAA
ARRRRRARRRRA
ARRRRRARRRRA
ARRURRARRRRA
ARRRRRAURRRA
ARRRRRAAAAAA
ARRRRRRRRRRA
BRRRRQQRRRRE
BRRRRQQRRRRE
BRRRSQQSRRRE
ARRRRRRRRRRA
AAAAAAAAAAAA