AAAAAAAIIIIA
ARRRRRBRRRRE
BRRRRRBRRRRE
BRRRRRBRRRRE
BRRRRRBRRRRE
ARRRRRACCCCA
ARRRRRRRRRRA
ARRRRRRRRRRA
ARRRRRRRRRRA
ARRRRRRRRRRA
ARRRRRRRRRRA
AAAAAAAAAAAA