AIIIIIIIIIIIA   
ARRRRRRRRRRRA   
ARRRRRRRRRRRA   
ARRRRRRRRRRRA   
ARRRRRRRRRRRA   
ARRRRRRRRRRRA   
ARRRRRRRRRRRA   
ASRRRRRRRRRRA   
ARRRRRRRRRRRA   
ARRRRRRRRRRRAAAA
BRRRRRRRRRRRAAUE
ARRRRRRRRRRRAARA
ARRRRRRRRRRRAARA
ARRRRRURRRRRAARA
ARRRRRRRRRRRAARA
ARRRRRRRRRRRAARA
ARRRRRRRRRRRAARA
ARRRRRRRRRRRAARA
ARRRRRRRRRRRAARA
ARRRRRRRRRRRAAAA
ARRRRRRRRRRRA   
ASRRRRRRRRRRA   
ARRRRRRRRRRRA   
ARRRRRRRRRRRA   
ARRRRRRRRRRRA   
ACCCCCCCCCCCA   