AAAAAAAAAAAAA   
BRRRRRRRRRRRE   
BRRRRRRRRRRRE   
BRRRRRRRRRRRE   
BRRRRRRRRRRRE   
BRRRRRRRRRRRE   
BRRRRRRRRRRRE   
BRRRRRRRRRRRE   
BRRRRRRRRRRRE   
BRRRRRRRRRRREAIA
ARRRRRRRRRRREBRA
BRRRRRRRRRRREBRE
BRRRRRRRRRRREBRE
BRRRRRRRRRRREBRE
BRRRRRRRRRRREBRE
BRRRRRRRRRRREBRE
BRRRRRRRRRRREBRE
BRRRRRRRRRRREBRE
BRRRRRRRRRRREBRE
BRRRRRRRRRRREACA
BRRRRRRRRRRRE   
BRRRRRRRRRRRE   
BRRRRRRRRRRRE   
BRRRRRRRRRRRE   
BRRRRRRRRRRRE   
AAAAAAAAAAAAA   