   AAAAAAAA   
   ARRRRRRA   
    ARRRRA    
AA  ARRRRA  AA
ARAA ARRA AARA
ARRAAARRAARRRA
ARRRRRRRRRRRRA
ARRRRRRRRRRRRA
ARRRAARRAARRRA
ARAA ARRA AARA
AA  ARRRRA  AA
    ARRRRA    
   ARRRRRRA   
   AAAAAAAA   