       AA       
      AQQA      
      AQQA      
     AQQQQA     
AAAAAAQQQQAAAAAA
AAQQQQQQQQQQQQAA
 AQQQQAQQAQQQQA 
  AQQQAQQAQQQA  
   AQQAQQAQQA   
   AQQQQQQQQA   
  AQQQQQQQQQQA  
  AQQQQQQQQQQA  
 AQQQQQAAQQQQQA 
 AQQQAA  AAQQQA 
AAAAA      AAAAA
AAA          AAA