       AA       
      ARRA      
      ARRA      
     ARRRRA     
AAAAAARRRRAAAAAA
AARRRRRRRRRRRRAA
 ARRRRARRARRRRA 
  ARRRARRARRRA  
   ARRARRARRA   
   ARRRRRRRRA   
  ARRRRRRRRRRA  
  ARRRRRRRRRRA  
 ARRRRRAARRRRRA 
 ARRRAA  AARRRA 
AAAAA      AAAAA
AAA          AAA