                AAA        
          AAAAAAASAAAAAAAAA
          ARARRRRRRRARRRRRA
          ARARAAARARARARARA
AAAAAAAAAAARARARARARRRARARA
AQQQQQQQQQARARARARARAAARARA
AQQQQQQQQQARARARARARARRRARA
AQQQQQQQQQARARARARARARAAARA
AQQQQQQQQQARRRARRRARARRRRRA
AQQQQUQQQQARAAARAAARAAAAARA
AQQQQQQQQQARRRRRARRRARRRRRA
AQQQQQQQQQAAARARARARARARAAA
AQQQQQQQQQARRRARRRARRRARRRA
AQQQQQQQQQARAAAAAAARAAAAARA
AAAAAAAAAAARARRRARRRARRRRRA
          ARARARAAAAARAAARA
          ARRRARRRRRRRARRRA
          AAAAAAAAAUAAAAAAA
                  ARA      
                  ARA      
                  AAA      
