                AAA        
          AAAAAAASAAAAAAAAA
          ARARRRRRRRARRRRRA
          ARARAAARARARARARA
AIIIIIIIIIARARARARARRRARARA
BQQQQQQQQQERARARARARAAARARA
BQQQQQQQQQERARARARARARRRARA
BQQQQQQQQQERARARARARARAAARA
BQQQQQQQQQERRRARRRARARRRRRA
BQQQQUQQQQERAAARAAARAAAAARA
BQQQQQQQQQERRRRRARRRARRRRRA
BQQQQQQQQQEAARARARARARARAAA
BQQQQQQQQQERRRARRRARRRARRRA
BQQQQQQQQQERAAAAAAARAAAAARA
ACCCCCCCCCARARRRARRRARRRRRA
          ARARARAAAAARAAARA
          ARRRARRRRRRRARRRA
          AAAAAAAAAUAAAAAAA
                  ARA      
                  ARA      
                  AAA      
