                AIA        
          AIAIIIJSMIAIIIIIA
          BRFRRRRRRRFRRRRRE
          BRFRGCDRHRNRHRHRE
AAAAAAAAAABRFRFRFRFRRRFRFRE
AQQQQQQQQQBRFRFRFRFRGKJRFRE
AQQQQQQQQQBRFRFRFRFRFRRRFRE
AQQQQQQQQQBRNRFRNRFRFROKJRE
AQQQQQQQQQBRRRFRRRFRFRRRRRE
AQQQQUQQQQBROKJRGKJREKKKLRE
AQQQQQQQQQBRRRRRFRRRFRRRRRE
AQQQQQQQQQAKLRHRNRHRNRHROKA
AQQQQQQQQQBRRRFRRRFRRRFRRRE
AQQQQQQQQQBRGKIKCKJRGKIKLRE
AAAAAAAAAABRFRRRFRRRFRRRRRE
          BRNRHRMKKKJRGKLRE
          BRRRFRRRRRRRFRRRE
          ACCCACCCDUGCACCCA
                  BRE      
                  BRE      
                  ACA      
