                              
                     AAA      
                   AARRRAA    
                 AARRRRRRRA   
               AARRRRRRRRRRA  
             AARRRRRRRRRRRRRA 
           AARRRRRRRRRRRRRRRA 
         AARRRRRRRRRRRRRRRRRRA
       AARRRRRRRRRRRRRRRRRRRRA
     AARRRRRRRRRRRRRRRRRRRRRKA
   AARRRRRRRRRRRRRRRRRRRRRRKRA
 AARRAAAAARRRRRRRRRRRRRRRKKRRA
ARRAARRARRKKKKKRRRRRRKKKKRRRRA
AARRARARARRRRRRKKKKKKRRRRRRAA 
AARRRARARARRRRRRRRRRRRRRRAA   
ARAARRARRARRRRRRRRRRRRRAA     
ARRRARRAARARRRRRRRRRRAA       
ARRRRARRARARRRRRRRRAA         
 ARRRARRRAARRRRRRAA           
 ARRRRAARRARRRRAA             
  ARRRRARRARRAA               
   ARRRRARAAA                 
    AARRRAA                   
      AAAA                    