                        
                        
  AIIIIIIIIIIIIIIA      
  BQQQQQQQQQQQQQQE      
  BQQQQQQQQQQQQQQE      
  BQQQQQQQQQQQQQQE  AAA 
  BQQQQQQQQQQQQQQE  ASA 
  BQQQQQQQQQQUQQQE  AUA 
  BQQQQQQQQQQQQQQE  ARA 
  BQQQQQQQQQQQQQQE  ARA 
  BQQQQQQQQQQQQQQE  AAA 
  BQQQQQQQQQQQQQQE      
  BQQQQQQQQQQQQQQE      
  BQQQQQQQQQQQQQQE      
  BQQQQQQQQQQQQQQE      
  BQQQQQQQQQQQQQQE      
  BQQQQQQQQQQQQQQE      
  ACCCCCCCCCCCCCCA      
                        
                        