                        
                        
  AAAAAAAAAAAAAAAA      
  ARRRRRRRRRRRRRRA      
  ARRRRRRRRRRRRRRA      
  ARRRRRRRRRRRRRRA  AIA 
  ARRRRRRRRRRRRRRA  ARE 
  ARRRRRRRRRRRRRRA  ARE 
  ARRRRRRRRRRRRRRA  ARE 
  ARRRRRRRRRRRRRRA  ARE 
  ARRRRRRRRRRRRRRA  AAA 
  ARRRRRRRRRRRRRRA      
  ARRRRRRRRRRRRRRA      
  ARRRRRRRRRRRRRRA      
  ARRRRRRRRRRRRRRA      
  ARRRRRRRRRRRRRRA      
  ARRRRRRRRRRRRRRA      
  AAAAAAAAAAAAAAAA      
                        
                        