AAAAAAAAAAAAAAAAIAAAA
ARJRRRRRREBRRRRRRRRRE
ARRRRRRRRRRRRRRRRRRRA
ARRRRRRRRRRRRARRQRRRA
ARRRRRRRRRQRRBRRRRRRE
ARDRURMRRAAAAARRCAAAA
ARRRRRRRRAAIAIRRRAIA 
AAAARRRRRAARRRAARARA 
ARRRARRRRAAARRABRRRE 
ARRRRACARA ARRAAARRA 
ARRRRRARRA ABRRRERRA 
ARRRRRRRAAA ACRSURCA 
ARRRRRRRBRRA AAARRRE 
ARRRRRRRAARRA  ARAAA 
AAAAAAAAA ACA  AAA   