AAAAAAAAAAAAAAAAAAAAA
ARARRRRRRAARRRRRRRRRA
ARRRRRRRRRRRRRRRRRRRA
ARRRRRRRRRRRRHRRRRRRA
ARRRRRRRRRRRRARRRRRRA
ARARRRARRAAAAARRAAAAA
ARRRRRRRRAAAAARRRAAA 
AAAARRRRRAARRRAARARA 
ARRRARRRRAAARRAARRRA 
ARRRRAAARA ARRAAARRA 
ARRRRRARRA AARRRARRA 
ARRRRRRRAAA AARRRRAA 
ARRRRRRRARRA AAARRRA 
ARRRRRRRAARRA  ARAAA 
AAAAAAAAA AAA  AAA   