AAAAAAAAAAAAAAAA
AQQQQQQAQQQQQQQA
AQQQUQQAQAQQQQQA
AQQAAQQAQQQAAQQA
AQQQQQQAQQARRAQA
AQQQQQQAQQARRAQA
AAAAAAAAQQQAAQQA
AQQQSQQQAQQQQQQA
AQAQQQQQAQQAQQQA
AQSAQQQAQQQAQQQA
AQQQQQAQQQAQQUQA
AQQQQAQQQAQQQQQA
AQAQAQQQAQQAQQQA
AQAQAQQAQQQQAQQA
AQQQQQQAQQQQQQQA
AAAAAAAAAAAAAAAA