AIIIIIIAAAAAAAAA
BRRRRRRERRRRRRRA
BRRRRRRERARRRRRA
BRRAARRERRRAARRA
BRRRRRRERRARRARA
BRRRRRRERRARRARA
ACCCCCCARRRAARRA
ARRRRRRRARRRRRRA
ARARRRRRARRARRRA
ARRARRRARRRARRRA
ARRRRRARRRARRRRA
ARRRRARRRARRRRRA
ARARARRRARRARRRA
ARARARRARRRRARRA
ARRRRRRARRRRRRRA
AAAAAAAAAAAAAAAA