      AIIA      
     AJQQMA     
    AJQQQQMA    
   AJQQQQQQMA   
  AJQQQQQQQQMA  
 AJQQSQQQQSQQMA 
AJQQQQAAAAQQQQMA
BQQQQQAAAAQQQQQE
BQQQQQAAAAQQQQQE
ADQQQQAAAAQQQQGA
 ADQQSQQQQSQQGA 
  ADQQQQQQQQGA  
   ADQQQQQQGA   
    ADQQQQGA    
     ADQQGA     
      ACCA      