      AAAA      
     AARRAA     
    AARRRRAA    
   AARRRRRRAA   
  AARRRRRRRRAA  
 AARRRRRRRRRRAA 
AARRRRGCCDRRRRAA
ARRRRREAABRRRRRA
ARRRRREAABRRRRRA
AARRRRMIIJRRRRAA
 AARRRRRRRRRRAA 
  AARRRRRRRRAA  
   AARRRRRRAA   
    AARRRRAA    
     AARRAA     
      AAAA      