AIAAAAAA  
AQRRRRRA  
AQRRRRRA  
AQRRRRRA  
AQRRRRRA  
AQRRRRRA  
AQRRRRRA  
AQRRRRRA  
AQRRRRRA  
ACAAAAAA  