1,5,1,5
0,-1,1,4
0,-1,1,3
0,-1,1,2
0,-1,1,1
0,-1,1,8
0,-1,1,7
0,-1,1,6
