    AAAAAAA               
   AARRRRRA    AAAAAA     
   ARRRSRRAA AAARRRRAA    
   ARRRRRRRA ARRRRRRSA    
   AARRRRRRA ARRRRRRRAAA  
    ARRRRRRAAARRRRRRRRRA  
    ARRRRRAARRRRRRRRRRRA  
   AARRRRRARRRRRRRRRRRRA  
   ARRRRRRARRRRRRRRRRRRAAA
   ARRRRRRIARRRRRRRRRRRRRA
  AARRRRRRRIIARRRRRRRRRRRA
  ARRRRRRRRRRARRRRRRRRRRRA
  ARRCCCCRRRRARRRRRRRRRRAA
  ARRAAAAARRRAAAABRRRRREA 
  AAAAAAAARRRA   BRRRRREA 
  AAAAAAAARRRAA  BRRRRRRE 
  ARRAAAAJRRRRE ABRRRRRRE 
  ARRAAIJRRRRRE ARRRRRRRAA
  ARRRRRRRRRRCA ARRRRRRRRA
  AARRRRRRRRCA  AARRRRRRRA
   ARRRRRRRCA    AARRRRRRA
   ARRRRRRCA      AARRRRRA
   ARRRRRCA        ARRRRAA
   AARRRCA         ARRRRA 
    ARRCA          ARRRRA 
    ARRA           ARRRRA 
    ARRA          AARRRRA 
    ARRA         AARRRRRAA
  AAARRA        AARRRRRRRA
  ARRRRA        ARRRRRRRRA
  ARRRRA       AARRRRRRRRA
  ARRRRA       BRRRRRRRREA
 AARRRRA       BRRRRRRRRE 
 ARRRRRA       BRRRRRRRRE 
 ARRRRRA       BRRRRRRRRE 
 ARRRRRA       ABRRRRRRRE 
 ARRRRRA        BRRRRRRRE 
 ARRRRRA        ARRRRRRRA 
AARRRRRAA       AARRRRRAA 
ARRRRRRRA        ARRRRRA  
ARRRRRRRA        ARRRRRA  
ARRRRRRRA       AARRRRRA  
ARRRRRRRA       ARRRRRRAA 
ARRRRRRRA      AARRRRRRRA 
ARRRRRRRAAAAAAAARRRRRRRRA 
ARRRRRRRRRRRARRRRRRRRRRRAA
ARRRRRRRRRRRARRRRRRRRRRRRA
ARRRRRURRRRRARRRRRRURRRRRA
ARRRRRRRRRRRARRRRRRRRRRRRA
AAAAAAAAAAAAAAAAAAAAAAAAAA