    AIIIIIA               
   AJRRRRRE    AIIIIA     
   BRRRRRRMA AAARRRRMA    
   BRRRRRRRA ARRRRRRRE    
   ADRRRRRRA ARRRRRRRMIA  
    BRRRRRRAAARRRRRRRRRE  
    BRRRRRAARRRRRRRRRRRE  
   AJRRRRRARRRRRRRRRRRRE  
   BRRRRRRARRRRRRRRRRRRAAA
   BRRRRRRAARRRRRRRRRRRRRE
  AJRRRRRRRAAARRRRRRRRRRRE
  BRRRRRRRRRRFRRRRRRRRRRRE
  BRREAABRRRRFRRRRRRRRRRGA
  BRREAAADRRREAAAARRRRRCA 
  ACCAAAABRRRE   ARRRRRIA 
  AIIAAAABRRRMA  ARRRRRRA 
  BRREAAAARRRRA AARRRRRRA 
  BRRMIAARRRRRA ARRRRRRRAA
  BRRRRRRRRRRAA ARRRRRRRRA
  ADRRRRRRRRAA  AARRRRRRRA
   BRRRRRRRAA    AARRRRRRA
   BRRRRRRAA      AARRRRRA
   BRRRRRAA        ARRRRAA
   ADRRRAA         BRRRRE 
    ARRAA          BRRRRE 
    ARRA           BRRRRE 
    ARRA          AJRRRRE 
    ARRA         AJRRRRRMA
  AIIRRA        AJRRRRRRRE
  BRRRRE        BRRRRRRRRE
  BRRRRE       AJRRRRRRRRE
  BRRRRE       ARRRRRRRRCA
 AJRRRRE       ARRRRRRRRA 
 BRRRRRE       ARRRRRRRRA 
 BRRRRRE       ARRRRRRRRA 
 BRRRRRE       ACRRRRRRRA 
 BRRRRRE        ARRRRRRRA 
 BRRRRRE        BRRRRRRRE 
AJRRRRRMA       ADRRRRRGA 
BRRRRRRRE        BRRRRRE  
BRRRRRRRE        BRRRRRE  
BRRRRRRRE       AJRRRRRE  
BRRRRRRRE       BRRRRRRMA 
BRRRRRRRE      AJRRRRRRRE 
BRRRRRRRMIIIAIIJRRRRRRRRE 
BRRRRRRRRRRRFRRRRRRRRRRRMA
BRRRRRRRRRRRFRRRRRRRRRRRRE
BRRRRRRRRRRRFRRRRRRRRRRRRE
BRRRRRRRRRRRFRRRRRRRRRRRRE
ACCCCCCCCCCCACCCCCCCCCCCCA