AAAAAAAAAAAAAAAAAAAAAAAAA
ARRRRRRRAARRRRAARRRRRRRAA
ARAARAARRRQAARRRRAARAARSA
ARRRRRRRAARRRRAARRRRRRRAA
AAAAAAAAAAAAAAAAAAAAAAAAA