                AIA        
          AIAIIIJRMIAIIIIIA
          BRFRRRRRRRFRRRRRE
          BRFRGCDRHRNRHRHRE
AAAAAAAAAABRFRFRFRFRRRFRFRE
ARRRRRRRRRBRFRFRFRFRGKJRFRE
ARRRRRRRRRBRFRFRFRFRFRRRFRE
ARRRRRRRRRBRNRFRNRFRFROKJRE
ARRRRRRRRRBRRRFRRRFRFRRRRRE
ARRRRRRRRRBROKJRGKJREKKKLRE
ARRRRRRRRRBRRRRRFRRRFRRRRRE
ARRRRRRRRRAKLRHRNRHRNRHROKA
ARRRRRRRRRBRRRFRRRFRRRFRRRE
ARRRRRRRRRBRGKIKCKJRGKIKLRE
AAAAAAAAAABRFRRRFRRRFRRRRRE
          BRNRHRMKKKJRGKLRE
          BRRRFRRRRRRRFRRRE
          ACCCACCCDRGCACCCA
                  BRE      
                  BRE      
                  ACA      