                   AAA        
AIIIIIIIIIIIIAAAAAAASAAAAAAAAA
BQQQQQQQQQQQQERARRRRRRRARRRRRA
BQQQQQQQQQQQQERARAAARARARARARA
BQQQQQQQQQQQQERARARARARRRARARA
BQQQQQQQQQQQQERARARARARAAARARA
BQQQQQQQQQQQQERARARARARARRRARA
BQQQQQQUQQQQQERARARARARARAAARA
BQQQQQQQQQQQQERRRARRRARARRRRRA
BQQQQQQQQQQQQERAAARAAARAAAAARA
BQQQQQQQQQQQQERRRRRARRRARRRRRA
BQQQQQQQQQQQQEAARARARARARARAAA
BQQQQQQQQQQQQERRRARRRARRRARRRA
BQQQQQQQQQQQQERAAAAAAARAAAAARA
ACCCCCCCCCCCCARARRRARRRARRRRRA
             ARARARAAAAARAAARA
             ARRRARRRRRRRARRRA
             AAAAAAAAAUAAAAAAA
                     ARA      
                     ARA      
                     AAA      