AAIAIAIAIAIA
AQQQQQQQQQQA
BQQQQQQQQQQE
AQQQQQQQQQQA
BQQQQQQQQQQE
AQQQQQQQQQQA
BQQQQQQQQQQE
AQQQQQQQQQQA
BQQQQQQQQQQE
AQQQQQQQQQQA
BQQQQQQQQQQE
AACACACACACA