        AIIIIIIIIA        
       AJQQQQQQQQMA       
      AJQQQQQQQQQQMA      
     AJQQQQQQQQQQQQMA     
    AJQQQQQQQQQQQQQQMA    
   AJQQQQQQQQQQQQQQQQMA   
  AJQQQQQQQQQQQQQQQQQQMA  
 AJQQQQQQQQQQQQQQQQQQQQMA 
AJQQQQQQQQQQQQQQQQQQQQQQMA
BQQQQQQQQGCCCCCCDQQQQQQQQE
BQQQQQQQQEQQQQQQBQQQQQQQQE
BQQQQQQQQEQQQQQQBQQQQQQQQE
BQQQQQQQQEQQSUQQBQQQQQQQQE
BQQQQQQQQEQQQQQQBQQQQQQQQE
BQQQQQQQQEQQQQQQBQQQQQQQQE
BQQQQQQQQEQQQQQQBQQQQQQQQE
BQQQQQQQQMIIIIIIJQQQQQQQQE
ADQQQQQQQQQQQQQQQQQQQQQQGA
 ADQQQQQQQQQQQQQQQQQQQQGA 
  ADQQQQQQQQQQQQQQQQQQGA  
   ADQQQQQQQQUQQQQQQQGA   
    ADQQQQQQQQQQQQQQGA    
     ADQQQQQQQQQQQQGA     
      ADQQQQQQQQQQGA      
       ADQQQQQQQQGA       
        ACCCCCCCCA        