AAAAAAAAAAAA
AQQQQQQQQQQA
AQQSQQQQSQQA
AQSQQTTQQSQA
AQQQQQQQQQQA
AQQQQQQQQQQA
AQQQQQQQQQQA
AQQQQQQQQQQA
AQQQQQQQQQQA
AQQQQQQQQQQA
AQQQQQQQQQQA
AAAAAAAAAAAA