         AAA        
 AAAAAAAAASAAAAAAAAA
 ARRRRRRRARRRRRRRRRA
 ARAAAAAAAAAAAAAAARA
 ARRRRRRRARRRRRARRRA
 ARAAARARARARARARAAA
 ARARARARARARARARARA
 AAARAAARARARARARARA
 ARRRRRRRARARARRRARA
 ARAAAAAAARAAARAAARA
 ARARRRRRRRRRARRRRRA
 ARARARARARAAARAAAAA
 ARARARARARARARARARA
 ARARARAAAAARAAARARA
 ARARARARRRRRRRRRARA
 ARARAAARAARAAAARARA
 ARARRRRRRARARRRRARA
 ARAAAAARAAAAARARARA
 ARRRRRRRARRRRRARRRA
 AAAAAAAAARAAAAAAAAA
 AARRRRRRRRRRRRRRAAA
  ARRRRRRRRRRRRRRA  
  ARRRRRRRRRRRRRRA  
  AAAAAAAAAAAAAAAA  