AIIIIIIIIAAAAAAAAAA
BQQQQQQQQEQQQQQQQQA
BQQQQQQQQEQQQQQQQQA
BQQQQQQQQEQQQQQQQQA
BQQQQQQQQEQQQQQQQQA
BQQQQQQQQEQQQQQQQQA
BQQQQQQQQEQQQQQQQQA
BQQQQUQQQEQQQQUQQQA
BQQQQQQQQEQQQQQQQQA
BQQQQQQQQEQQQQQQQQA
BQQQQQQQQEQQQQQQQQA
BQQQQQQQQEQQQQQQQQA
BQQQQQQQQEQQQQQQQQA
BQQQQQQQQEQQQQQQQQA
BQQQQQQQQEQQQQQQQQA
ACCCCCCCCAAAAAAAAAA
