        AAAAAAAAAA        
       AARRRRRRRRAA       
      AARRRRRRRRRRAA      
     AARRRRRRRRRRRRAA     
    AARRRRRRRRRRRRRRAA    
   AARRRRRRRRRRRRRRRRAA   
  AARRRRRRRRRRRRRRRRRRAA  
 AARRRRRRRRRRRRRRRRRRRRAA 
AARRRRRRRRRRRRRRRRRRRRRRAA
ARRRRRRRRAIIIIIIARRRRRRRRA
ARRRRRRRRBRRRRRRERRRRRRRRA
ARRRRRRRRBRRRRRRERRRRRRRRA
ARRRRRRRRBRRRRRRERRRRRRRRA
ARRRRRRRRBRRRRRRERRRRRRRRA
ARRRRRRRRBRRRRRRERRRRRRRRA
ARRRRRRRRBRRRRRRERRRRRRRRA
ARRRRRRRRACCCCCCARRRRRRRRA
AARRRRRRRRRRRRRRRRRRRRRRAA
 AARRRRRRRRRRRRRRRRRRRRAA 
  AARRRRRRRRRRRRRRRRRRAA  
   AARRRRRRRRRRRRRRRRAA   
    AARRRRRRRRRRRRRRAA    
     AARRRRRRRRRRRRAA     
      AARRRRRRRRRRAA      
       AARRRRRRRRAA       
        AAAAAAAAAA        