AIIIIIIIIIIA
BQQQQQQQQQQE
BQQQQQQQQQQE
BQQQQQQQQQQE
BQQQQQQUQQQE
BQQQQSQQQQQE
BQQQQQQQQQQE
BQQQQQQQQQQE
BQQQQQQQQQQE
ACCCCCCCCCCA
AQQQQQQQQSQA
AQQQQQQQQQQA
AQQQQQQQQQQA
AQQQQQQQQQQA
AQQQQQQUQQQA
AQQQQQQQQQQA
AQQQQQQQQQQA
AQQQQQQQQQQA
AQQQQQQQQQQA
AAAAAAAAAAAA