AAAAAAAAAAAAA               
ARRRRRRRRRRIA               
ARRRRRRRRRRRE               
ARRRRRRRRRRCA  AAAAAAAAAAAAA
ARRRRRRRRRRRA  ARRRRRRRRRRRA
ARRRRRRRRRRRA  ARRRRRRRRRRRA
ARRRRRRRRRRRA  ARRRRRRRRRRRA
ARRRRRRRRRRRA  ARRRRRRRRRRRA
ARRRRRRRRRRRA  ARRRRRRRRRRRA
ARRRRRRRRRRRA  AIRRRRRRRRRRA
ARRRRRRRRRRRA  BRRRRRRRRRRRA
ARRRRRRRRRRRA  ACRRRRRRRRRRA
ARRRRRRRRRRRA  ARRRRRRRRRRRA
ARRRRRRRRRRRA  ARRRRRRRRRRRA
ARRRRRRRRRRRA  ARRRRRRRRRRRA
ARRRRRRRRRRRA  ARRRRRRRRRRRA
ARRRRRRRRRRRA  AAAAAAAAAAAAA
ARRRRRRRRRRRA               
ARRRRRRRRRRRA               
AAAAAAAAAAAAA               