     IIIIIII   
    IRRRRRRRA  
   ARRRRRRRRRA 
   ARRRIIIIIIA 
   BRRAQQQQQQQE
 AABRRAQQQQQQQE
ARSBRRAQQQQQQQE
ASTBRRAQQQQQQQE
ARSARRRAAAAAAA 
BRRARRRRRRRRRE 
BRRARRRRRRRRRE 
BSRARRRRRRRRRE 
BTSARRRRRRRRRE 
BSRARRRRRRRRRE 
 AAARRRCCCCRRA 
   ARRRA ARRRA 
   ARRRA ARRRA 
   ARRRA ARRRA 
    CCC   CCC  