AAAAAAAAAAAAAAAAAAAA
ASRRRRRRRRRRRSAQQQQA
ATAAAAAAAAAAAAAQAAQA
AQQQQAQQQAAQQQAQQAQA
AQAAQAQAQQQQAQAAQAQA
AQAAQAQAAQAAAQAQQAQA
AQQAQQQQAQQQQQQQAAQA
AAQAQAAQQQQQAAAQQQQA
AAQQQQQQQAAQQQQQAQQA
AAAAAAAAAAAAAAAAAAAA