AAAAAAAAAAAAAAAAAAAA
ARRRRRRRRRRRRRARRRRA
ARAAAAAAAAAAAAARAARA
ARRRRARRRAARRRARRARA
ARAARARARRRRARAARARA
ARAARARAARAAARARRARA
ARRARRRRARRRRRRRAARA
AARARAARRRRRAAARRRRA
AARRRRRRRAARRRRRARRA
AAAAAAAAAAAAAAAAAAAA