AIIIIIIIIIIIIIIIIIIIIIIA
B@QQQQQQQQQQQQQQQQQQQQQE
BQQQQQQQQQQQQQQQQQQQQQQE
BQQQQQSQQQQQQQQQSQQQQQQE
BQQQQQQQQQQQQQQQQQQQQQQE
BQQQQQQQQQQQQQQQQQQQQQQE
BQQQQQQQQQQQQQQQQQQQQQQE
BQQQQQQQQQQQQQQQQQQQQQQE
BQQQQQQQQQQQQQQQQQQQQQQE
BQQQQQQQQQQQQQQQQQQQQQQE
BQQQQTQQQQQQQQQQQQQQQQQE
BQQQQQQQQQQQQQQQQQQQQQQE
BQQQQQQQQQQQQQTQQQQQQQQE
BQQQQQQQQQQQQQQQQQQQQQQE
BQQQQQQQQQQQQQQQQQQQQQQE
ACCCCCCCCCCCCCCCCCCCCCCA
