AIIIIIIIIIIA
ARRRRRRRRRRA
ARRTTTTTTRRA
ARRRRRRRRRRA
AAAARRRRAAAA
  ARRRRRRA  
  ARGCCDRA  
AAARMIIJRAAA
ARRRRRRRRRRA
ARRRRRRRRRRA
ARTTRRRRTTRA
ATSSTTTTSSTA
ACCCCCCCCCCA