AAAAAAAAAAAA
ARRRRRRRRRRA
ARRRRRRRRRRA
ARRRRRRRRRRA
AAAARRRRAAAA
  BRRRRRRE  
  BRAAAARE  
AIJRAAAARMIA
BRRRRRRRRRRE
BRRRRRRRRRRE
BRRRRRRRRRRE
BRRRRRRRRRRE
AAAAAAAAAAAA