10,9,10,9
-1,0,9,9
-1,0,8,9
-1,0,7,9
-1,0,6,9
-1,0,5,9
-1,0,4,9
-1,0,3,9
-1,0,2,9
-1,0,1,9
0,-1,1,8
1,0,2,8
1,0,3,8
1,0,4,8
1,0,5,8
1,0,6,8
