AAAAAAAAAAAAAAAAAAAAAAAAAAAA
ARRRRRRRRRRRRRRRRRRRRRRRRRRA
ARRRRRRRRRRRRRRRRRRRRRRRRRRA
ARRRRRRRRRRRRRRRRRRRRRRRRRRA
ARRRRRRRRRRRRRRRRRRRRRRRRRRA
ARRRRRRRRRRRRRRRRRRRRRRRRRRA
ARRRRRRRRRRRRRRRRRRRRRRRQRRA
ARRRRRRRRRRRRRRRRRRRRRRRRRRA
ARRRRRRRRRRRRRRRRRRRRRRRRRRA
AAAAAAAAAAAAAAAAAAAAAAAAAAAA