AIIIIIIIIIIIIIIIIIIA
BRRRRRRRRRRRRRRRRRRE
BRRRRRRRRRRRRRRRRRRE
BRRRRRRRRRRRRRRRRRRE
BRRRRRRRRRRRRRRRRRRE
BRRRRSRRRRURRRRRRSRE
BRRRRRRRRRRRRRRRRRRE
BRRRRRRRRRRRRRRRRRRE
BRRRRRRRRRRRRRRRRRRE
BRRRRRRRRRRRRRRRRRRE
AKKKKKKKKKKKKKKKKKKA
BQQQQQQQQQQQQQQQQQQE
BQQQQQQQQQQQQQQQQQQE
BQQQQQQQQQQQQQQQQQQE
BQQQQQQQQQQQQQQQQQQE
BQQQQQQQQQUQQQQQQQQE
BQQQQQQQQQQQQQQQQQQE
BQQQQQQQQQQQQQQQQQQE
BQQQQQQQQQQQQQQQQQQE
BQQQQQQQQQQQQQQQQQQE
ACCCCCCCCCCCCCCCCCCA