AIIIIIIIIIAAIIIIIIIIIA
BQQQQQQQQQAAQQQQQQQQQE
BQQQQQQQQQAAQQQQQQQQQE
BQQSQQQQQQAAQQQQQQQQQE
BQQQQQQQQQAAQQQQQQQQQE
BQQQQQQQQQAAQQQQQQQQQE
BQQQQQQQQQAAQQQQQQQQQE
BQQQQQQQQQAAQQQQQQQQQE
BQQQQQQQQQAAQQQQQQQQQE
BQQQQQQQQQAAQQQQQQQQQE
AAAAAAAAAAAAAAAAAAAAAA
AAAAAAAAAAAAAAAAAAAAAA
BQQQQQQQQQAAQQQQQQQQQE
BQQQQQQQQQAAQQQQQQQQQE
BQQQQQQQQQAAQQQQQQQQQE
BQQQQQQQQQAAQQQQQQQQQE
BQQQQQQQQQAAQQQQQQQQQE
BQQQQQQQQQAAQQQQQQQQQE
BQQQQQQQQQAAQQQQQQSQQE
BQQQQQQQQQAAQQQQQQQQQE
BQQQQQQQQQAAQQQQQQQQQE
ACCCCCCCCCAACCCCCCCCCA