   AAAAAAAA   
   ARRRRRRA   
    ARRRRA    
AA  ARRRRA  AA
ARAA ARRA AARA
ARRAAARSAARRRA
ARRRRSRRRRRRRA
ARRRRRRRSRRRRA
ARRRAASRAARRRA
ARAA ARRA AARA
AA  ARRRRA  AA
    ARRRRA    
   ARRRRRRA   
   AAAAAAAA   