 AAAAAAAAAAA        
 AQQQQQQQQQAAAAAAAAA
 AQQQQQQQQQQQQQQQQQA
 AQQQQQQQQQQQQQQQQQA
 AQQQQQQQQAQQQQQQQQA
 AQQQQQQQQAQQQQQQQQA
 AQQQQQQQQAQQQQQQQQA
 AQQQQQQQQAQQQQQQQQA
 AQQAAAQQQAQQQQQQQQA
AAQQQQAQQQAAAAAAAAAA
AQQQQQAQQQQQQQQQA   
AQQQQQAQQQQQQQQQA   
AQQQQQAQQQQTQQQQA   
AQQQQQAQQQSSSQQQA   
AAAAAAAQQTSQSTQQA   
      AQQQSSSQQQA   
      AQQQQTQQQQA   
      AQQQQQQQQQA   
      AQQQQQQQQQA   
      AAAAAAAAAAA   