         AIIIIIA         
       AIJQQQQQMAA       
     AIJQQQQQQQQMAAA     
    AJQQQQQQQQQQQEQAA    
   AJQQQQQQQQQQQQMQQAA   
  AJQQQQQQQGCDQQQQEQQAA  
  BQQQQQQQQEABQQQQEQQQA  
 AJQQQQQQQQMIJQQQQEQQQAA 
 BQQQQQQQQQQQQQQQEQQQQQA 
AJQQQQQQQQQQQQQQQEQQQQQAA
BQQQQQQQQQQQQQQQGQQQQQQQA
BQQQSQQQQQQQQQGCQQQQTQQQA
BQQSUSQQQQQGCCQQQQQTUTQQA
BQQQSQQQQGCQQQQQQQQQTQQQA
BQQQQQQQGQQQQQQQQQQQQQQQA
ADQQQQQGQQQQQQQQQQQQQQQAA
 BQQQQQEQQQQQQQQQQQQQQQA 
 ADQQQGQQQQAAAQQQQQQQQAA 
  BQQQEQQQQAAAQQQQQQQQA  
  ADQQMQQQQAAAQQQQQQQAA  
   ADQQEQQQQQQQQQQQQAA   
    ADQEQQQQQQQQQQQAA    
     ACAAQQQQQQQQAAA     
       AAAQQQQQAAA       
         AAAAAAA         