         AAAAAAA         
       AAARRRRRAAA       
     AAARRRRRRRRAAIA     
    AARRRRRRRRRRRBRMA    
   AARRRRRRRRRRRRBRRMA   
  AARRRRRRRAAARRRRDRRMA  
  ARRRRRRRRAAARRRRBRRRE  
 AARRRRRRRRAAARRRRJRRRMA 
 ARRRRRRRRRRRRRRRDRRRRRE 
AARRRRRRRRRRRRRRRJRRRRRMA
ARRRRRRRRRRRRRRRJRRRRRRRE
ARRRRRRRRRRRRRIJRRRRRRRRE
ARRRRRRRRRRIIJRRRRRRRRRRE
ARRRRRRRRIJRRRRRRRRRRRRRE
ARRRRRRRJRRRRRRRRRRRRRRRE
AARRRRRBRRRRRRRRRRRRRRRGA
 ARRRRRJRRRRRRRRRRRRRRRE 
 AARRRBRRRRGCDRRRRRRRRGA 
  ARRRBRRRREABRRRRRRRRE  
  AARRBRRRRMIJRRRRRRRGA  
   AARRDRRRRRRRRRRRRGA   
    AARBRRRRRRRRRRRGA    
     AAADRRRRRRRRGCA     
       AADRRRRRGCA       
         ACCCCCA         