AIIIIIIIIA  AIIIIIIIIA
BQQQQQQQUE  BQQQQQQQQE
BQQQQQQQQE  BQQQQQQQQE
BQQQQQQQQE  BQQQQQQQQE
BQQQQQQQQE  BQQQQQQQQE
BQQQQQQQQE  BQQQQQQQQE
BQQQQQQQQE  BQQQQQQQQE
BQQQQQQQQE  BQQQQQQQQE
BQQQQQQQQE  BUQQQQQQQE
ACCCCCCCCA  ACCCCCCCCA