AAAAIIAAAA
AQQQQSQQQA
AQQQQQQQQA
AQQQQQQQQA
BQQQQQQQQE
BQQQQQQQQE
AQQQQQQQQA
AQQQQQQQQA
AQQQQSQQQA
AAAACCAAAA