AAAAAAAAIIIIIAAAAAAAAAAAAAAAAAIIIIIIIIIIIIIAAAAAAAAAAAAAAA
AAAAAAAARRRRRRRRRRRRRRRRRRRRRBRRRRRRRRRRRRRERRRRRRRRRARRRA
AAAAAAAARAAAAAAAAARAAAAARAAARBRRRRRRRRRRRRRERAAARAAAAARARA
AAAAAAAARRRARARRRARRRARRRARRRBRRRRRRURRRRRRERARRRRRRRARARA
AAAAAAAARARARARAAAAARAAAAARAABRRRRRRRRRRRRRERARAAAAARARAAA
AAAAAAAARARARARRRRRARRRARARARBRRRRRRRRRRRRRERARRRARRRARRRA
AAAAAAAARARARAAARARAAARARARARAAAAAAAAAAAAAAAAAAARARARAAARA
AAAAAAAARARRRARRRARARRRARRRRRARRRARRRARRRRRRRRRRRARARARARA
AAAAAAAAAAAARAAAAARAAAAAAAAARARAAARARARAAAAARAAAAAAARARARA
AAAAAAAARARARRRARRRRRRRRRRRARARRRRRARARARRRARRRRRARARRRRRA
AAAAAAAARARAAARAAAAAAAAAAARAAAAAAARARAAAAARAAAAARARAAARAAA
AAAAAAAARRRRRBRRRRRRRRRRRARARARRRRRARRRRRARRRRRARRRRRERRRA
AAAAAAAARAAAAAAAAARAAAAARARARBRAAAAAAARARAAAAARAAAAAREAARA
AAAAAAAARARRRRRARARARRRRRARRRARRRRRARRRARRRBRRRRRRRARERARA
AAAAAAAARBRARAAARAAARAAARARAAARAAAAAAAAAAARARAAARAAARERARA
AAAAAAAARARARRRRRRRRRARRRBRARARARRRRRRRARARARRRARRRARERRRA
ARRRRRRARARAAAAAAAAAAAAAAARARARARAAAABRARARAAAAARARAREAAAA
ARRRRRRARARARRRRRARRRRRRRRRARARRRARRRRRARARRRRRRRARRRRRRRA
ARRRRRSARARARAAAAAAAAARARAAARAAAAARAAAAARAAAAARAAARAAARAAA
ARRRRRRARRRARARRRARRRRRARARRRRRRRARRRRRRRRRARARRRARARARARA
ARRRRRRARAAARARAAARAAARARARAIIIIIIIIIARARAAARARARARARARARA
ARRRRRRARARRRARARRRARARARRRBRRRRRRRRRERARARARARARARRRARARA
AAAAAARARARAAARARAAARAAAAARBRRRRRRRRRERAAARARAAARAAAAARARA
AARRRARARRRRRRRARARRRRRRRARBRRRRRRRRRERRRRRARARRRARRRRRRRA
AARARARAAARAAARARAAARAAARAABRRRRRRRRREAARAAARAAAAARAAARAAA
AARAUARARRRARRRARRRARARRRRRRRRRRRRRRRRRRRRRARRRRRRRARRRARA
AARARARAAARAAAAARARARARAAAABRRRRRRRRREAAAARAIIIIIIIAAAAARA
ARRRRRRARRRARRRARARARARARRRBRRRRRRRRRERRRARAQQQQQQQERARRRA
ARRRRRRARAAARARARAAAAARARARBRRRRRRRRRERARARAQQQQQQQERARAAA
ARRRRRRARRRARARARARRRARARARBRRRRRRRRRERARARAQQQQQQQERARRRE
ARRRRRRAAARAAARARARARARAAARACCCCCCCCCAAARAABQQQQQQQERBRARE
ARRRRRRARARRRARRRRRARARRRARRRRRARRRRRARARRRBQQQQQQQERBRARE
ARRRRRSARAAARAAAAAAARARAAARAAAAARARARARARAIBQQQQQQQERBRARE
ARRRRRRARRRARRRRRRRARARRRRRRRRRRRARARARRRRRBQQQQQQQERBRARE
ARRRRRRAAARAAAAAAARARARAAAAAAARAAARARIIIIIRBQQQQQQQERBRARE
AAAAAAAARARARRRARRRARRRARRRRRARARRRARRRRRRRBQQQQQQQERRRARE
AAAAAAAARARAAARARAAAAARAAAAARARAAARAAAAAAAABQQQQQQQERAAARE
AAAAAAAARRRRRARARARRRRRARRRRRARRRARRRARRRRRBQQQQQQQERARRRE
AAAAAAAARAAARARARAAAAAAAAAAARAAARAAAAARAAAAACCCCCCCAAARARE
AAAAAAAARARARRRRRRRRRRRRRARARRRRRRRRRARRRRRARRRARRRRRARARE
AAAAAAAAAARAAAAAAAAARAAAAARAAAAARAAARARAAARARARAAARARAAARE
AAAAAAAARRRRRRRRRARRRARRRRRRRRRRRARARRRARRRARARRRRRARRRRRE
AAAAAAAARARAAAAARAAAAAAARAAAAAAARARAACCACCCARAAAAARAAARAAA
AAAAAAAARARARRRRRARRRRRARRRRRARRRARRRRRARRRRRRRRRARRRARARA
AAAAAAAAAARAAARAAARAAARAAAAARAAAAARAAAAARAAAAARARAAAAARARA
AAAAAAAARARRRARRRRRARRRARRRARARRRRRRRARRRARARARARARRRARRRA
AAAAAAAARARAAAAAAARAAARARAAARARAAARARAAARARARARARARARAAARA
AAAAAAAARARRRRRARRRRRARARARRRARARARARRRARRRARRRARARARRRRRA
AAAAAAAARAAARAAARAAARAAARARAAARARARAACRAAARAAAAAAARARAAAAA
AAAAAAAARRRRRARRRRRARRRRRRRRRARRRARRRARRRRRARRRRRRRARRRRRA
AAAAAAAACCCCCAAAAAAAAAAAAAAAAAAAAAAAAACCCCCAAAAAAAAAAAAAAA