AIIIIIIA   AIIIIA   AAAAAAAA
AQQQQQQA   BRRRRA   AQQQQQQE
AQQQQQQA   BRRRRA   AQQQQQQE
AQQQQQQA   BRRRRA   AQQQQQQE
AQQQQQQA   BRRRRA   AQQQQQQE
AQQQQQQA   BRRRRA   AQQQQQQE
AQQQQQQA   BRRRRA   AQQQQQQE
AAAAAAAA   BRRRRE   AAAAAAAA
           BRRRRE           
           BRRRRE           
AAAAAAAIIIIJRRRRMIIIIIIIIIIA
BRRRRRRRRRRRRRRRRRRRRRRRRRRE
BRRRRRRRRRRRRRRRRRRRRRRRRRRE
BRRRRRRRRRRRRRRRRRRRRRRRRRRE
BRRRRRRRRRRRRRRRRRRRRRRRRRRE
ACCCCCCCCCCDRRRRGCCCCAAAAAAA
           BRRRRE           
           BRRRRE           
AAAAAAAA   BRRRRE   AAAAAAAA
BQQQQQQA   ARRRRE   AQQQQQQA
BQQQQQQA   ARRRRE   AQQQQQQA
BQQQQQQA   ARRRRE   AQQQQQQA
BQQQQQQA   ARRRRE   AQQQQQQA
BQQQQQQA   ARRRRE   AQQQQQQA
BQQQQQQA   ARRRRE   AQQQQQQA
AAAAAAAA   ACCCCA   ACCCCCCA