AAAAAAAAAAAAA               
AQQQQQQQQQQAA               
AQQQQQQQQTQSA               
AQQQQQQQQQQAA  AAAAAAAAAAAAA
AQQQQQQQQQQQA  ARRRRRRRRRRRA
AQQQQQQQQQQQA  ARRRRRSRRRRRA
AQQQQQQQQQSQA  ARRRRRRRRRRRA
AQQQQQQQQQQQA  ARRSRRRRRSRRA
AQQQQQQQTQTQA  ARRRRRRRRRRRA
AQQQQQUQQQQQA  AARRRRRRRRRRA
AQQQQQQQQQSQA  ASRRRRURRRRSA
AQQQQQQQQQQQA  AARRRRRRRRRRA
AQQQQQQQQQQQA  ARRSRRRRRSRRA
AQQQQQQQQQQQA  ARRRRRRRRRRRA
AQQQQQQQQQQQA  ARRRRRSRRRRRA
AQQQQQQQQQQQA  ARRRRRRRRRRRA
AQQQQQQQQQQQA  AAAAAAAAAAAAA
AQQQQQQQQQQQA               
AQQQQQQQQQQQA               
AAAAAAAAAAAAA               