AAAAAAAAAAAAAAAAAAAAAAAAAAAAAAAAAAAAAAAAAAAAAAAAAAAAAAAAAA
AAAAAAAARRRRRRRRRRRRRRRRRRRRRARRRRRRRRRRRRRARRRRRRRRRARRRA
AAAAAAAARCCCCAAAAARAAAAARAAARARRRRRRRRRRRRRARAAARAAAAARARA
AAAAAAAARRRARARRRARRRARRRARRRARRRRRRRRRRRRRARARRRRRRRARARA
AAAAAAAARARARARAAAAARAAAAARAAARRRRRRRRRRRRRARARAAAAARARAAA
AAAAAAAARARARARRRRRARRRARARARARRRRRRRRRRRRRARARRRARRRARRRA
AAAAAAAARARARAAARARAAARARARARACCCCCCCCCCCCCAAAAARARARAAARA
AAAAAAAARARRRARRRARARRRARRRRRARRRARRRARRRRRRRRRRRARARARARA
AAAAAAAACAAARAAAAARAAAAAAAAARARAAARARARAAAAARAAAAAAARARARA
AAAAAAAARARARRRARRRRRRRRRRRARARRRRRARARARRRARRRRRARARRRRRA
AAAAAAAARARAAARAAAAAAAAAAARAAAAAAARARAAAAARAAAAARARAAARAAA
AAAAAAAARRRRRARRRRRRRRRRRARARARRRRRARRRRRARRRRRARRRRRARRRA
AAAAAAAARAAAAAAAAARAAAAARARARAREAAAAAARARAAAAARAAAAARAAARA
AAAAAAAARARRRRRARARARRRRRARRRARRRRRARRRARRRARRRRRRRARARARA
AAAAAAAARARERAAARAAARAAARARAAARAAAAAAAAAAARARAAARAAARARARA
AAAAAAAARARARRRRRRRRRARRRARERARARRRRRRRARARARRRARRRARARRRA
ARRRRRRARARAAAAAAAAAAAAAAARARARARAAAAARERARAAAAARARARAAAAA
ARRRRRRARARARRRRRARRRRRRRRRARARRRARRRRRARARRRRRRRARRRRRRRA
ARRRRRRARARARAAAAAAAAARARAAARAAAAARAAAAARAAAAARAAARAAARAAA
ARRRRRRARRRARARRRARRRRRARARRRRRRRARRRRRRRRRARARRRARARARARA
ARRRRRRARAAARARAAARAAARARARAAAAAAAAAAARARAAARARARARARARARA
ARRRRRRARARRRARARRRARARARRRARRRRRRRRRARARARARARARARRRARARA
AAAAAARARARAAARARAAARAAAAARARRRRRRRRRARAAARARAAARAAAAARARA
AARRRARARRRRRRRARARRRRRRRARARRRRRRRRRARRRRRARARRRARRRRRRRA
AARARARAAARAAARARAAARAAARAAARRRRRRRRRAAARAAARAAAAARAAARAAA
AARARARARRRARRRARRRARARRRRRRRRRRRRRRRRRRRRRARRRRRRRARRRARA
AARARARAAARAAAAARARARARAAAAARRRRRRRRRAAAAARAAAAAAAAAAAAARA
ARRRRRRARRRARRRARARARARARRRARRRRRRRRRARRRARBRRRRRRRARARRRA
ARRRRRRARAAARARARAAAAARARARARRRRRRRRRARARARBRRRRRRRARARAAA
ARRRRRRARRRARARARARRRARARARARRRRRRRRRARARARBRRRRRRRARARRRA
ARRRRRRAAARAAARARARARARAAARAAAAAAAAAAAAARAAARRRRRRRARARARA
ARRRRRRARARRRARRRRRARARRRARRRRRARRRRRARARRRARRRRRRRARARARA
ARRRRRRARAAARAAAAAAARARAAARAAAAARARARARARAAARRRRRRRARARARA
ARRRRRRARRRARRRRRRRARARRRRRRRRRRRARARARRRRRARRRRRRRARARARA
ARRRRRRAAARAAAAAAARARARAAAAAAARAAARARAAAAARARRRRRRRARARARA
AAAAAAAARARARRRARRRARRRARRRRRARARRRARRRRRRRARRRRRRRARRRARA
AAAAAAAARARAAARARAAAAARAAAAARARAAARAAAIAAAAARRRRRRRARAAARA
AAAAAAAARRRRRARARARRRRRARRRRRARRRARRRARRRRRARRRRRRRARARRRA
AAAAAAAARAAARARARAAAAAAAAAAARAAARAAAAARAAAIAAAAAAAAAAARARA
AAAAAAAARARARRRRRRRRRRRRRARARRRRRRRRRARRRRRARRRARRRRRARARA
AAAAAAAAAARAAAAAAAAARAAAAARAAAAARAAARIRAIIRARARAAARARAAARA
AAAAAAAARRRRRRRRRARRRARRRRRRRRRRRARARRRARRRARARRRRRARRRRRA
AAAAAAAARARAAAAARAAAAAAARAAAAAAARARAAAAAAAAARAAAAARAAARAAA
AAAAAAAARARARRRRRARRRRRARRRRRARRRARRRRRARRRRRRRRRARRRARARA
AAAAAAAAIARAAARAAARAAARAAAAARAAAAARAAAAARAIAAARARAAAAARARA
AAAAAAAARARRRARRRRRARRRARRRARARRRRRRRARRRARARARARARRRARRRA
AAAAAAAARARAIAAAAARAAARARAAARARAAARARIIARARARARARARARAAARA
AAAAAAAARARRRRRARRRRRARARARRRARARARARRRBRRRARRRARARARRRRRA
AAAAAAAARIIIRAAARAAARAAARARAAARARARAAARIIIRAAAAAAARARAAAAA
AAAAAAAARRRRRARRRRRARRRRRRRRRARRRARRRARRRRRARRRRRRRARRRRRA
AAAAAAAAAAAAAAAAAAAAAAAAAAAAAAAAAAAAAAAAAAAAAAAAAAAAAAAAAA