9,6,9,6
-1,0,8,6
-1,0,7,6
-1,0,6,6
-1,0,5,6
-1,0,4,6
