                AAA        
          AAAAAAASAAAAAAAAA
          ARARRRRRRRARRRRRA
          ARARAAARARARARARA
          ARARARARARRRARARA
  AAAAAAAAARARARARARAAARARA
  AQQQQQQQARARARARARARRRARA
  AQQQQQQQARARARARARARAAARA
  AQQQQQQQARRRARRRARARRRRRA
  AQQQUQQQARAAARAAARAAAAARA
  AQQQQQQQARRRRRARRRARRRRRA
  AQQQQQQQAAARARARARARARAAA
  AQQQQQQQARRRARRRARRRARRRA
  AAAAAAAAARAAAAAAARAAAAARA
          ARARRRARRRARRRRRA
          ARARARAAAAARAAARA
          ARRRARRRRRRRARRRA
          AAAAAAAAAUAAAAAAA
                  ARA      
                  ARA      
                  AAA      