                AIA        
          AIAIIIJRMIAIIIIIA
          BRARRRRRRRFRRRRRE
          BRFRGCDRHRNRHRHRE
          BRFRFRFRFRRRFRFRA
  AAAAAAAABRFRARFRARGAJRFRE
  ARRRRRRRBRFRFRFRFRFRRRFRE
  ARRRRRRRBRNRFRNRFRFROKJRE
  ARRRRRRRBRRRFRRRFRARRRRRE
  ARRRRRRRBROAJRGKJREKKKLRE
  ARRRRRRRBRRRRRARRRFRRRRRE
  ARRRRRRRAKARHRNRHRNRHROKA
  ARRRRRRRBRRRFRRRFRRRFRRRE
  AAAAAAAABRGKIKCKJRGAIKLRE
          BRFRRRFRRRFRRRRRE
          BRNRHRMAKKJRGALRE
          BRRRARRRRRRRFRRRE
          ACCCACCCDRGCACCCA
                  BRE      
                  BRE      
                  ACA      