 AAAAAAAAAAA        
 ARRRRRRRRRAAAAAAAAA
 ARRRRRRRRRRRRRRRRRA
 ARRRRRRRRRRRRRRRRRA
 ARRRRRRRRARRRRRRRRA
 ARRRRRRRRARRRRRRRRA
 ARRRRRRRRARRRRRRRRA
 ARRRRRRRRARRRRRRRRA
 ARRAAARRRARRRRRRRRA
AARRRRARRRAAAAAAAAAA
ARRRRRARRRRRRRRRA   
ARRRRRARRRRRRRRRA   
ARRRRRARRRRRRRRRA   
ARRRRRARRRRRRRRRA   
AAAAAAARRRRRRRRRA   
      ARRRRRRRRRA   
      ARRRRRRRRRA   
      ARRRRRRRRRA   
      ARRRRRRRRRA   
      AAAAAAAAAAA   