  AA AAAAA      
 ATTAQQQQQAA    
AQQAQQQQQQQQA   
AQQQQQAQAQQQQA  
AQQQQQAQAQQQQA  
AQQQQQAQAQQQQQA 
AQQQSSQQQSSQQQQA
AQQQQQQAQQQQQQQA
 AQQQQQAQQQQQQQA
 AQQQQQQQQQQQQA 
 AQQQQQQQQQQQQQA
  AQQQQQQQQQQQQA
  AAQQQQQQQQQQQA
 ARRAAQQQAQQQQA 
ARRRRRAAAAAQQA  
 AAAAAA   AAA   