  II IIIII      
 JRRNRRRRRMI    
BRRPRRRRRRRRM   
BRRRRRHRHRRRRE  
BRRRRRFRFRRRRM  
BRRRRRNRNRRRRRM 
BRRRRRRRRRRRRRRE
BRRRRRRHRRRRRRRE
 DRRRRRNRRRRRRRE
 BRRRRRRRRRRRRO 
 BRRRRRRRRRRRRRE
  DRRRRRRRRRRRRE
  ILRRRRRRRRRRRE
 JRROLRRRHRRRRG 
BRRRRRGCCADRRG  
 CCCCCA   ACC   