AAAAAAAAAAAA
ARRRRRRRRRRA
ARRRRRRRRRRA
ARRRRRRRRRRA
ARRRRRRRRRRA
ARRRRRRRRRRA
ARRRRRRRRRRA
ARRRRRRRRRRA
ARRRRRRRRRRA
AIIIIIIIIIIA
BRRRRRRRRRRE
BRRRRRRRRRRE
BRRRRRRRRRRE
BRRRRRRRRRRE
BRRRRRRRRRRE
BRRRRRRRRRRE
BRRRRRRRRRRE
BRRRRRRRRRRE
BRRRRRRRRRRE
ACCCCCCCCCCA