AAIIIIIIAA
AQQQQQQQQA
AQQQQQQQQA
AQQQQQQQQA
AQQQQQQQQA
AQQQQQQQQA
AQQQQQQQQA
AAAAAAAAAA
          
          
          
          
 AAAAAAAA 
 ASRRRRSA 
 ARSRRSRA 
 ARRRRRRA 
 ARRRRRRA 
 ACCCCCCA 