AAAAAAAAAA
ARRRRRRRRA
ARRRRRRRRA
ARRRRRRRRA
ARRRRRRRRA
ARRRRRRRRA
ARRRRRRRRA
AAAAAAAAAA
          
          
          
          
 AAAAAAAA 
 ARRRRRRA 
 ARRRRRRA 
 ARRRRRRA 
 ARRRRRRA 
 AAAAAAAA 