10,7,10,7
-1,0,9,7
-1,0,8,7
-1,0,7,7
-1,0,6,7
-1,0,5,7
