AAAAAAAAAA
AQQQQQQQQA
AQQQSQQQQA
AQQQQQQQQA
AQQQQQQQQA
AQQQQQQQQA
AQQQQQQQQA
AQQQQQQQQA
AQQQQQQQQA
AAAAAAAAAA