     AAAAAAA   
    ARRRRRRRA  
   ARRRRRRRRRA 
   ARRRAAAAAAA 
   ARRARRRRRRRA
 AAARRARRRRRRRA
ARRARRARRRRRRRA
ARRARRARRRRRRRA
ARRARRRAAAAAAA 
ARRARRRRRRRRRA 
ARRARRRRRRRRRA 
ARRARRRRRRRRRA 
ARRARRRRRRRRRA 
ARRARRRRRRRRRA 
 AAARRRAAAARRA 
   ARRRA ARRRA 
   ARRRA ARRRA 
   ARRRA ARRRA 
    AAA   AAA  