AAAAAAAAAA
ARRRRRRRRA
ARRRQRRRRA
ARRRRRRRRA
ARRRRRRRRA
ARRRRRRRRA
ARRRRRRRRA
ARRRRRRRRA
ARRRRRRRRA
AAAAAAAAAA