AAAAAAAAAA
ARRRRRRRRA
ARRRRRRRRA
ARRRRRRRRA
ARRRRRRRRA
ARRRRRRRRA
ARRRRRRRRA
ARRRRRRRRA
ARRQRRRRRA
AAAAAAAAAA