AAAAAAAAAAAAAAAAAAAAAAAAA
ARRRRRRRAARRRRAARRRRRRRAA
ARAARAARRRRAARRRRAARAARRA
ARRRRRRRAARRRRAARRRRRRRAA
AAAAAAAAAAAAAAAAAAAAAAAAA