AAAAAAAAAAAAAA
ARRRRRAARRRRRA
ARRRRRAARRRRRA
ARRURRAARRURRA
ARRRRRAARRRRRA
ARRRRRAARRRRRA
ARRRRRAARRRRRA
ARRRRRAARRRRRA
ARRRRRAARRSRRA
AAAAAAAAAAAAAA