AIIIIIAAIIIIIA
BRRRRREBRRRRRE
BRRRRREBRRRRRE
BRRRRREBRRRRRE
BRRRRREBRRRRRE
BRRRRREBRRRRRE
BRRRRREBRRRRRE
BRRRRREBRRRRRE
BRRRRREBRRRRRE
ACCCCCAACCCCCA