AIIIIIIIIIIIIIIIIIIIIIIA
BQQQQQQQQQQQQQQQQQQQQQQE
BQQQQQQQQQQQQQQQQQQQQQQE
BQQQQQQQQQQQQQQQQQQQQQQE
BQQQQQQQQQQQQQQQQQQQQQQE
BQQQQQQQQQQQQQQQQQQQQQQE
BQQQQQQQQQQQQQQQQQQQQQQE
BQQQQQQQQQQQQQQQQQQQQQQE
BQQQQQQQQQQQQQQQQQQQQQQE
BQQQQQQQQQQQQQQQQQQQQQQE
BQQQQQQQQQQQQQQQQQQQQQQE
BQQQQQQQQQQQQQQQQQQQQQQE
BQQQQQQQQQQQQQQQQQQQQQQE
BQQQQQQQQQQQQQQQQQQQQQQE
BQQQQQQQQQQQQQQQQQQQQQQE
ACCCCCCCCCCCCCCCCCCCCCCA
