     AAAAAAAAAAAAAAAAAAA
    AQQQQQQQQQQQQQQQQQQA
    AQQQQQQQQQQQQQQQQQQA
   AQQQQQQQQQQQQQQQQQQQA
   AQQQQQQQQQQQQQQQQQQA 
   AQQQQQQQQQQQQQQQQQQA 
   ARAAQQQQQQQQQQQQQQQA 
    AQQQQQAQQQQQQQQQQA  
    AQQQQQQAAAAQQQQQQA  
     AQQQQQQQQAAQQQQA   
      AQAQQQQQQQQQAA    
      AQAQQQAAQQQQRA    
      AQQQQQRAAQQQA     
      AQQQQQAQQQQA      
     AQQQQQQQQQQA       
     AQTQQQQQQQA        
     AQQTQQQQQQA        
     AQTTQQQQQAA        
    ATTTTTQQQA          
     AQQQQTQQA          
      AQQQQQA           
       AQQAA            
        AAA             
                        