     AAAAAAAAAAAAAAAAAAA
    ARRRRRRRRRRRRRRRRRRA
    ARRRRRRRRRRRRRRRRRRA
   ARRRRRRRRRRRRRRRRRRRA
   ARRRRRRRRRRRRRRRRRRA 
   ARRRRRRRRRRRRRRRRRRA 
   ARAARRRRRRRRRRRRRRRA 
    ARRRRRARRRRRRRRRRA  
    ARRRRRRAAAARRRRRRA  
     ARRRRRRRRAARRRRA   
      ARARRRRRRRRRAA    
      ARARRRAARRRRRA    
      ARRRRRRAARRRA     
      ARRRRRARRRRA      
     ARRRRRRRRRRA       
     ARRRRRRRRRA        
     ARRRRRRRRRA        
     ARRRRRRRRAA        
    ARRRRRRRRA          
     ARRRRRRRA          
      ARRRRRA           
       ARRAA            
        AAA             
                        