     AAAAAAAAAA     
     AQQQQQQQQA     
     AQQQQQQQQA     
     AQQQQQQQQA     
     AQQQQQQQQA     
AAAAAAQQQQQQQQAAAAAA
AQQQQQQQQQQQQQQQQQQA
AQQQQQQQQQQQQQQQQQQA
AQQQQQQQAAAAQQQQQQQA
AQQQQQQQAAAAQQQQQQQA
AQQQQQQQAAAAQQQQQQQA
AQQQQQQQAAAAQQQQQQQA
AQQQQQQQQQQQQQQQQQQA
AQQQQQQQQQQQQQQQQQQA
AAAAAAQQQQQQQQAAAAAA
     AQQQQQQQQA     
     AQQQQQQQQA     
     AQQQQQQQQA     
     AQQQQQQQQA     
     AAAAAAAAAA     