AAAAAAAAAAIIIIIIIIA
AQQQQQQQQBQQQQQQQQE
AQQQQQQQQBQQQQQQQQE
AQQQQQQQQBQQQQQQQQE
AQQQQQQQQBQQQQQQQQE
AQQQQQQQQBQQQQQQQQE
AQQQQQQQQBQQQQQQQQE
AQQQQQQQQBQQQQQQQQE
AQQQQQQQQBQQQQQQQQE
AQQQQQQQQBQQQQQQQQE
AQQQQQQQQBQQQQQQQQE
AQQQQQQQQBQQQQQQQQE
AQQQQQQQQBQQQQQQQQE
AQQQQQQQQBQQQQQQQQE
AQQQQQQQQBQQQQQQQQE
AAAAAAAAAACCCCCCCCA
