     AAAAAAAAAA     
     ARRRRRRRRA     
     ARRRRRRRRA     
     ARRRRRRRRA     
     ARRRRRRRRA     
AAAAAARRRRRRRRAAAAAA
ARRRRRRRRRRRRRRRRRRA
ARRRRRRRRRRRRRRRRRRA
ARRRRRRRAAAARRRRRRRA
ARRRRRRRAAAARRRRRRRA
ARRRRRRRAAAARRRRRRRA
ARRRRRRRAAAARRRRRRRA
ARRRRRRRRRRRRRRRRRRA
ARRRRRRRRRRRRRRRRRRA
AAAAAARRRRRRRRAAAAAA
     ARRRRRRRRA     
     ARRRRRRRRA     
     ARRRRRRRRA     
     ARRRRRRRRA     
     AAAAAAAAAA     